NO ./file1.xpm
SO ./file2.xpm
WE ./file3.xpm
EA ./file4.xpm

F 220,100,0
C 225,30,0

1111111

11111
10N01
10001
10001
11111