NO ./file1.xpm
SO ./file2.xpm
WE ./file3.xpm
EA ./file4.xpm

F 220,100,0
C 225,30,0

        1111111111111111111111111
        1000000000110000000000001
        1                       1
        1011000001110000000000001
        1001000000000000000000001
111111111011000001110000000000001
100000000011000001110111111111111
1111011111111101110000001   1
11110111111111011101010010001
11000000110101011100000011001
10000000000000001100000010101
10000000000000001101010010W01
1100000111010101 111011110 0111
11110111 1110101 101111010001
11111111 1111111 111111111111