NO file1.xpm             
EA file4.xpm
SO file2.xpm
WE file3.xpm

C 200,100,20
F 150,50,10

111111
100001
100001
100001
111111