NO ./64x/xpm/2D_TEXTURE.xpm
SO ./64x/xpm/bookshelf.xpm
WE ./64x/xpm/Boris2.xpm
EA ./64x/xpm/Planks.xpm

F 255,246,227
C 191,236,255

11111111111111111111111111111
10000000D00000010101000000001
11111111100000010101000100001
1000000000W0000DDDD0000100001
10000111DDDDD0000000000100001
10000000011111111111000D00001
10000000000000000000000D00001
11111111110000000000000D00001
10000000000000000100000100001
10100000000000000100D00100001
10111111011110000100000100001
10100000010000000111000000001
10000000010001100000001111111
 111111111111111111111111111
