NO ./64x/xpm/2D_TEXTURE.xpm
SO ./64x/xpm/bookshelf.xpm
WE ./64x/xpm/Instagram_icon.xpm
EA ./64x/xpm/Gold1.xpm

F 255,246,227
C 191,236,255

11111111111111111111111111111111111111111111111111111111111111111111111111111111111111111111111111111111111111111111111111111111111111111111111111111111111111111111111111111111111111111111111111111111111111111111111111111111111111111111111111
10000000000000000000000000000000000001111111110000000000000000000000000000000000000000000000000000000000000000000000000000000000000000000000000000000000000000000000000000000000000000000000000000000000000000000000000000000000000000000001
10000000000000000000000000000000000001111111110000000000000000000000000000000000000000000011111111111111111111111111111111111111111111111111111111111111111111111111111111111111111111111111111111111111111111111111111111111111111111111111111111
1000000000000000000000000000000000000111111111000000000000000000000000000000000000000000001
1000000000000000000000000000000000000111111111000000000000000000000000000000000000000000001
1000000000000000000000000000000000000111111111000000000000000000000000000000000000000000001
1000000000000000000000000000000000000111111111000000000000000000000000000000000000000000001
1000000000000000000000000000000000000111111111000000000000000000000000000000000000000000001
1000000000000000000000000000000000000111111111000000000000000000000000000000000000000000001
1000000000000000000000000000000000000111111111000000000000000000000000000000000000000000001
1000000000000000000000000000000000000111111111000000000000000000000000000000000000000000001
1000000000000000000000000000000000000111111111000000000000000000000000000000000000000000001
1000000000000000000000000000000000000111111111000000000000000000000000000000000000000000001
1000000000000000000000000000000000000111111111000000000000000000000000000000000000000000001
1000000000000000000000000000000000000111111111000000000000000000000000000000000000000000001
1000000000000000000000000000000000000111111111000000000000000000000000000000000000000000001
1000000000000000000000000000000000000111000111000000000000000000000000000000000000000000001
1000000000000000000000000000000000000111000111000000000000000000000000000000000000000000001
1000000000000000000000000000000000000111000111000000000000000000000000000000000000000000001
1000000000000000000000000000000000000111000111000000000000000000000000000000000000000000001
1000000000000000000000000000000000000111000111000000000000000000000000000000000000000000001
1000000000000000000000000000000000000111000111000000000000000000000000000000000000000000001
1000000000000000000000000000000000000111000111000000000000000000000000000000000000000000001
1000000000000000000000000000000000000111000111000000000000000000000000000000000000000000001
1000000000000000000000000000000000000000000000000000000000000000000000000000000000000000001
1000000000000000000000000000000000000000000000000000000000000000000000000000000000000000001
1000000000000000000000000000000000000000000000000000000000000000000000000000000000000000001
1000000000000000000000000000000000000000000000000000000000000000000000000000000000000000001
1000000000000000000000000000000000000000000000000000000000000000000000000000000000000000001
1000000000000000000000000000000000000000000000000000000000000000000000000000000000000000001
10000000000000000000000000000000000000000N0000000000000000000000000000000000000000000000001
1000000000000000000000000000000000000000000000000000000000000000000000000000000000000000001
1000000000000000000000000000000000000000000000000000000000000000000000000000000000000000001
1000000000000000000000000000000000000000000000000000000000000000000000000000000000000000001
1000000000000000000000000000000000000000000000000000000000000000000000000000000000000000001
1000000000000000000000000000000000000000000000000000000000000000000000000000000000000000001
1000000000000000000000000000000000000111111111000000000000000000000000000000000000000000001
1000000000000000000000000000000000000111111111000000000000000000000000000000000000000000001
1000000000000000000000000000000000000111111111000000000000000000000000000000000000000000001
1000000000000000000000000000000000000111111111000000000000000000000000000000000000000000001
1000000000000000000000000000000000000111111111000000000000000000000000000000000000000000001
1000000000000000000000000000000000000111111111000000000000000000000000000000000000000000001
1000000000000000000000000000000000000111111111000000000000000000000000000000000000000000001
1000000000000000000000000000000000000111111111000000000000000000000000000000000000000000001
1000000000000000000000000000000000000111111111000000000000000000000000000000000000000000001
1000000000000000000000000000000000000111111111000000000000000000000000000000000000000000001
1000000000000000000000000000000000000111111111000000000000000000000000000000000000000000001
1000000000000000000000000000000000000111111111000000000000000000000000000000000000000000001
1000000000000000000000000000000000000111111111000000000000000000000000000000000000000000001
1000000000000000000000000000000000000111111111000000000000000000000000000000000000000000001
1000000000000000000000000000000000000111111111000000000000000000000000000000000000000000001
1000000000000000000000000000000000000111111111000000000000000000000000000000000000000000001
1000000000000000000000000000000000000111111111000000000000000000000000000000000000000000001
1000000000000000000000000000000000000111111111000000000000000000000000000000000000000000001
1000000000000000000000000000000000000111111111000000000000000000000000000000000000000000001
1111111111111111111111111111111111111111111111111111111111111111111111111111111111111111111