NO ./64x/xpm/2D_TEXTURE.xpm
SO ./64x/xpm/bookshelf.xpm
WE ./64x/xpm/Instagram_icon.xpm
EA ./64x/xpm/LavaF1.xpm

F 220,100,0
C 225,30,0

11111
10S01
10001
10001
11111