NO ./64x/xpm/2D_TEXTURE.xpm
SO ./64x/xpm/bookshelf.xpm
EA ./64x/xpm/Gold1.xpm

F 255,246,227
C 191,236,255

 111111111111111111111111111
10000000000000010101000000001
11111111100000010101000100001
1000000000W000001000000100001
10000111000000000000000100001
10000000011111111111000000001
10000000000000000000000000001
11111111110000000000000000001
10000000000000000100000100001
10100000000000000100000100001
10111111011110000100000100001
10100000010000000111000000001
10000000010001100000001111111
 111111111111111111111111111